001010101110110011010000100111
232303132030313112122323123120
030313010021031012131331020133
011311312331030133210031301211
022101310322301320322311031200
210130032103230300203120003332
211002020131212023003112331223
211223200210120222231010112103
202330322130313332203203113013
021313132112222221221332101121
210321023021203210210111212222
202120313310110312122112222101
232201001130213223033221112130
021222311122320013322011031203
212202203100122013012321022331
223233110330313011301303220111
030131221012110322200122222011
213021111323201222132031233300
010321013112031312122113210223
033011130312320301203020012332
203203210301202212111303211311
031131122103131010321022310312
001320010311221320212330000102
211032132032302102131012230231
210112223112030231011313132120
221130302220133211301131221333
210213230220220121122011321203
213201313013303130303012002203
203020321202020030312200320103
011312212332223120303322023203
021013022121322112122033212113
212321320311122011203221212222
222003121221222103032113223122
223300202110132031030303212222
221023032200111131003221210131
011213031330203001311301101001
031030130213122303013211303313
013033123030320113003021032121
003311210203221113301332212100
210013023201220132022010013132
032221230332101120212133322222
023032202013032113301011321112
222120033121013022222312222213
212103310210222303211211030322
211320312113021120131201111032
032013223032231112211332203203
030101110310322010113220311011
211213112120101223102032012203
031312223122132022232202211310
032103112103103330321132111313