011110111101101011101011101111011110110101110111010101001100110110001111101101010100110111100101101011110100110111000011
220213122210303030112131032032002221133013101132122132310330121312301021132020312132123211133213013031222223102031223021
213031220303122320322031220101323001320320101322132111212223113220312310301233222122121101312103113301201232030121230231
220131032131011203113032322003113211323102232200130103030320201313003012232212013010201111121022032020102222123230133301
010210011122302213120103213303110100130023112030032130311203321000232223212031103312103220313312013333033312031123120013
222022311102123301003120310201212231122221212203321012110112011233222322210031122212213102121221021122022101130322123322
213303010032032103213013212332100211232232011232111132033223031013211202013021230122120131131103322111303211130101302210
220022133132002230031001012122033001213011320031021123032101031013101132210203202220003202031111201031022203203220131013
033332212223322113312313030321221331020131033322321210322012122031200133313301023032203123200321231201330312022221221022
013010201021121302011013303203120201330300100321010303102133013203033022030120302323303212231022101121111201303212301221
222223030303030332132103112122223113032030331131021111033222012302112312102121330222120321001330322001222112101211132221
011103303230013032220320011112032212101323103222301311221010313022111320332102023302111012201020231313022213221121110303
022002211103310302201202111323202110010012203202231100312320202221320321033220330331211033322222312013232121112110132113
231323103112201123130023100012131223133032122030210231121003130203211010112033031211012030031320111031022112120202213211
013231200211130111302331223201131020312210322213313112011301133330310031203220121101322013311003032321211131012231130113
032202233013033211221102112332020201312320301130300113303232211212223303310133203112211113122203212032013031122211001001
020232101310311221022230100202313301031112013110033103202210310011320113011201321022101022103303102012032212133132313331
222113220132101222320003233133032130012223111122013201331031212201100322311310122212121312010103123312030130113220100302
212000120100231020132201203100121223313011311123212110212203112312122030220300312301303223322121122210211121222010321123
022233223132010231033332032032213201322032032011101032210100010312031133101130200132111000323031112222301311103020331112
233120302212033202221002003032210112100311032320221122132233212012103110201312331010101333031212001303122211013331221121
212230322202210131010333231130311203222011322222121212212221311131311103302123121033211031203212321021030031120120311211
202202023033210121120222111132001321231031111100330121101011121211021003123101132201031131032210222211012122032121132201
222031213222213011323101132210321200120301200131031312132220303001312310313211111331021110211202301212130203011213211221
232031113310311122202232022203030221301031323121221103111102211230320132102021012030322213110032103013223311222131021013
201310012031121231131200322022023011321132101221031101320123013210213121330201032023212120113220302101032022110322321130
032113031220003221031121201312313030312212131303312001213120320002310220133320311222103123212030330332112321112202212113
000130220323220122222112310312111031102111011032212322210010312331202203101123021312032003030133023201120212102232203221
231103211311223011211203213210312112030321031122103212203313012010132103202222300031311301210320322130203131033120202121
203131312103222212113120203020310033021113132202101323112222023201023212022022022322011231201302121033122100110012223120
222102000303311210131022031312223120303222200132122110323111230331200213333300321031210100101220311311221122202223220213
030123323102012103032233221222210313121212130301300032121031303103322103001223102321123233032032112022132133133301032320
210230201332222032112001112122210130122101313111222113112100031121133132232111320100310120131211111232220320032220032023
223103132201222131022302122001110313202013100111123122100133111320312220320301022133223130202111312303211213012023121211
001101211202221110311332032312203222023032132201310211130303100120011201020021330103220323321321021210012100312320332203
213222131033202011101031221320202212301113121011132001032013233223203020323311321202003211010320321033130321301321202322
222003112322023201303300210312321103111320311031113321110110310202200332230222022232303220021130331030211220332222232121
210210001302303300221122130220310312203021120103221011133011003321323122033121312213222003230211120322031103212213111121
213302330330031233030133213031222103211211102030321003221121312231121013102101311210111330303211112033020030310122200113
201033122212111031101012222011033213100302123111311332221103103211221130032020102133021100113312010310223010131202030122
231303221203121113012030303030310310332232112203222011031102003031102123030333032201220033003212310312203132212320131221
011111020221221110213133012321100303011011133221012203300033231111232200211210320122303212322101011032301210302033211212
221032213212120203132221132012120112013131101120322103123300321021110232131311033210230032022113120011312122032212201022
201030311012223101303212211220320310013211221200023212101233021312123103112001203123312101311300332321221311133030231332
203133103310310311101103010211331222122110221233301113131212311201003203120320210121013212201230130101103002102322310103
010320312121010222212132303310110321313102110203130011321301112102311032223032110231003101103322021300301230320012113122
221302122203212302100321203223003211122031322031213032221221021223210120012032033322320321021003300323203211022130132011
011133020201132230033003012220303101201203223011122030010310232101203113220310132210131030320311221122220203330310001320
222121212110320133011210121322003122120100303303103013221202121113303122311311221221012121333121210332132122201213212113
221101210212220303220211313013303201323032120320303203130320231102101202103021013202023221201212221113012021031310030302
210322122301300121322312200113011211231130101120302032223222311030112130222310310133321031012102210013202312301033031331
222013132232023211211121233211132031311010202231123000320233122210220322001202103020022212213032003130333021232112210321
003120201221303100221120003220320131013122333201303321313210320033131303332223013213332303121210303120122230121102101212
220033213012232132311222303212223203101130130000231003102212032010211110301310112113120210221222210320221120203123222303
233120020311121112202112210003201302202110303322310313232101022132200131313201132200222103330323011012313122311311210312
032003321311030310123223122232203221131132232033031221030132233012122031121030110133310210302201121122203123122222031132
221230211221311121331201212221000231010132020303203212220222113313231001032132212112023222232201312230300021220032210122
201022311312112222102231123013332311031111201302010000103030203001122230220210132200321320313010130310122311213201303120
232320220021220112131221200021201320203210312220033323131002113212221033033213001233001101111030312033120113211011131223
201013322332031320113030323303210222320002120023113210301332101033013321010210321010331231001221123012121113311131001130
232021212222211212103221010312203322222330202211322212211133231131011320302132113213120111322320222120111310103112202203
021231222210322221001030221210013112032123223032030032210212210013003223121131113112122212232123200221320311230210320303
230013121220011311320132321202102111130013302320303010122110323120302011203003212012001000101020132330320221223103030231
213121111103121001331110312332130010313311031112230223211131131123031302122310302202212232103330122011022201201120132322
211130002013232322211100320033213313212220301311123012210012101103312123120301133223302302102013133320333120122023001111
013223230101130211030130033013030211220023112011332131112302001332101112113201311332233130323031220130010321312312332211
021210312130023000311033030222122130103330301201220032203120212121032123103103031022102030213300303222322222011312111212
211033200313321231322221113113032102230321130331013201121122302010200322102220311300232003032230032112123231032003111032
211103221010031112001003110130101130200210031202032330013033133213232112023122222132320332201122301110002222022310312011
032232121213120212302220201310301322232312321131112122102300022310031212201002203121003020222112213023331032312220311321
222201121131123222123312103032201223110003211111001102121033322203022011331320010322212313222000011231222211111030121112
221231031021003010302210230132021201132303222020313120221322230313302121101033213222132101231233210112221220131313220300
220211121210211223232103212223313022223101103231010233211201220012222232131013320310103112122013311322202022221030101322
022121120123022002223030011012011201320312030203223203013113203021130322000301211013220323222310000120221311121022132123
220231132003202321021132031212302222111032133103311212031032303221212102231021101203203111113213231313201120013323120103
232013222222231231310123222320330201130133111112111301220130303203212033013230303010311103031032201300130333222102222121
032310132330220113033031101033103202121212013010112230301120320202012021122302102310310310120131203232111220113123110330
030001321123201101032113203001103323021112110021311301213012133322312231021031031301201222011103211211310101322120320302
033321012032231003003112103232221111330100213230321120121301110321130011330130310203303312012020131111112200310222023123
203101032103210322220210120310330111123023110012031032230102103110132300311130103201120212023332212221212031102113301331
211132221231132132302113223201221131032213113202010311213232113003103021321033112230112322311311221222122013123222211013
211220221031103032231131221232013010122001211221202003113222210310331322032220032033013011013032322210123012230201301113
030123311112132030210111301131121302100212210321221211122010130223032220220323032303122120010032101212120221112320003121
002103030320311003012112232220101123223213130222331321030312213311013033030022210031101333322220332220303111032033210220
233013011321022222033203222202213221222113213202030321013213121022203000033211313110330110203032001103131103301110133102
013112203110221322312031021033203101303122221333201012311212111220113332122012110001100123332030230310120110311023011332
222201013212232013210113311010022013110131110203031031121122103311003113110311222303233130220212311001321322103331112123
212231301302000220120301303202322003111012212303032130203012013200311311011122210313001222302223121330202202101103100222
010301220022332210322221103223103313221211303001002102230311222130110121310131213031213311023130122213031320330021123022
213231113320322113100310112321211310210122013220322133003201013201133001310003132122101130213011322103111023003330321211
011120210022203220132102123101131203220300221231323011232131101131013331212301121002110112320310311011220201331111232301
030102112222122123100022222213022130131222212200111032301201113003121100030222110321201310132011312221303301020300322031
033231133333110303233331321001300200203233032330113210222213013230322232322311303021331031123000101303221013303032112021
032102210322011011102110321211322123102121031212211202321011013122103222122110331213013212103323211212203203031132202220
031221220320303031132203031312031332031312110301320321021003110102010122221132000320012022232030311322103020303031022333
210120320120113201122102010312121200122113112102110131313332202133322230203211230113320311221011201112231233103020332203
022032013230113313031222211320310222021122222121212120321020232120122202011021312203121222031003310023221030001301200013
232313100203212222013231212200223323311311222203220103201332111311201333103311220100131211312222032330121132320331223312
203011333230200321211312032133221212202100011231310310301203210210322103122212031330310211221303203210303122231003313021
031221032203131131211122212121110130321323303132111123132231033113221011131212320130313130312032212111310322101331031232