01111001
03212231
00301221
22212131
21031210
02103322
23131213
03111031